25,25
0,0,0,0,0,0,1,1,0,0,0,0,0,0,0,0,0,0,0,0,0,0,0,0,0
0,0,0,0,0,0,0,0,1,0,0,0,0,0,0,0,0,0,0,0,0,0,5,5,5
0,0,0,0,1,1,0,1,0,0,0,0,0,0,0,0,0,0,0,0,5,5,5,5,5
0,0,0,0,1,0,1,1,0,0,0,0,0,0,0,0,0,0,0,5,5,5,5,5,5
0,0,0,0,1,0,1^,1,0,0,0,0,0,0,0,0,0,0,5,5,5,5,5,5,5
0,0,0,0,0,0,1,1,1,0,0,0,0,5,0,0,0,5,5,5,5,5,5,5,5
0,0,0,0,0,1,1,1*,0,0,0,0,0,5,0,0,0,5,5,5,5,5,5,5,5
0,0,0,0,0,0,0,0,0,0,0,0,5,5,5,5,5,5,5,5,5,5,5,5,5
0,0,0,0,0,0,0,2*,0,0,2,5,5,5,5,5,5,5,5,5,5,5,5,5,5
0,0,0,0,0,0,2,2,2,2,2,5,5,5,5,5,5,5,5,5^,5,5,5,5,5
0,0,0,0,0,0,0,2,2,2,2,2,5,5,5,5,5,5,5,5,5,5,5,5,5
0,0,0,0,0,0,0,2,2,2,2,3,3,3,5,0,5,5,5,5,5,5,5,5,5
0,0,0,0,0,0,0,2,2,2,3,3,3,3,3,0,5,5,5,5,5,5,5,5,5
0,0,4,0,0,0,2,2^,2,2,3,3^,3,0,0,0,5,5,5,5,5,5,5,5,5
0,4,4,4,0,0,2,2,2,2,2,3,3,0,0,0,5,5,5,5,5,5,5,5,5
0,4,4,4,4,4,2,2,0,2,0,3,3,3,0,0,0,5,5,5,5,5,5,5,5
4,4,4^,4,4,4,4,0,0,0,0,0,3,3,0,0,0,5*,5,5,5,5,5,5,5
0,4,4,4,4,4,4,0,0,0,0,0,3,3,3,0,0,0,5,5,5,5,5,5,5
0,4,4,4,4,0,0,0,0,0,0,0,3,3,3,0,0,0,5,5,5,5,5,5,5
0,4,4,4,4*,0,0,0,0,0,0,0,0,3,3,0,0,0,5,5,5,5,5,0,0
0,4,4,4,0,0,0,0,0,0,0,0,0,3,3,3*,0,0,5,5,5,5,5,0,0
0,0,4,0,0,0,0,0,0,0,0,0,0,3,0,3,0,0,5,5,5,5,5,0,0
0,0,0,0,0,0,0,0,0,0,0,0,3,3,0,0,0,0,0,5,5,0,0,0,0
0,0,0,0,0,0,0,0,0,0,0,3,3,0,0,0,0,0,0,0,0,0,0,0,0
0,0,0,0,0,0,0,0,0,0,0,3,3,0,0,0,0,0,0,0,0,0,0,0,0